አቶ → አቶ  
ወ/ሮ → ወይዘሮ  
ዶ/ር → ዶክተር  
ሸህ → ሸክ  
ቄስ → ቄስ  
ክቡር → ክቡር  
ክብርት → ክብርት  
ሻምበል → ሻምበል  
ኮሎኔል → ኰሎኔል  
አስር አለቃ → አስር አለቃ  
አምሳ አለቃ → ሀምሳ አለቃ  
ሻለቃ → ሻለቃ  
ጀኔራል → ጀነራል  
ፕሮፌሰር → ፕሮፌሰር  
ወታደር → ወታደር  
ኢንጅነር → ኢንጂነር  
ልኡል → ልኡል  
ራስ → ራስ  
አቡነ → አቡነ  
መምህር → መምህር  
አለቃ → አለቃ  
ብላታ → ብላታ  
ሀኪም → ሀኪም  
ነጋድራስ → ነጋድራስ  
ፕ/ት → ፕሮፌሰር  
አፈ ጉባኤ → አፈ-ጉባኤ  
ማእድንና ኢነርጂ ሚኒስትር → ሚኒስትር  
ወይዘሮ → ወይዘሮ  
ጠቅላይ ሚኒስትር → ጠ/ሚኒስትር  
ዳይሬክተር → ዳይሬክተር  
ሊቀ ጠበብት → ሊቀ ጠበብት  
ዶክተር → ዶክተር  
ሻንበል → ሻምበል  
ወ/ሮ → ወይዘሮ  
ኢንጂነር → ኢንጅነር  
ሰአሊ → ሰአሊ  
ፒያኒስት → ፒያኒስት  
ሚ/ር → ሚስተር  
ፕሬዝዳንት → ፕሬዝዳንት  
ፕ/ር → ፕሮፌሰር  
ፕረዝደንት → ፕሬዝደንት  
ካፒቴን → ካፒቴን  
ፓትሪያርክ → ፓትሪያርክ  
ኢንስፔክተር → ኢንስፔክተር  
ድኤታብፁእ → ድኤታብፁእ  
ተመራማሪ → ተመራማሪ  
ከንቲባ → ከንቲባ  
ሊቀመንበር → ሊቀመንበር  
ምክትል → ምክትል  
ሳጅን አ/አለቃ → ሳጅን አለቃ  
ሎሬት → ሎሬት  
አሰልጣኝ → አሰልጣኝ  
አምበል → አምበል  
ኡስታዝ → ኡስታዝ  
ኢንስትራክተር → ኢንስትራክተር  
ዋና ዳይሬክተር → ዋና ዳይሬክተር  
ጂ → ጂ  
አርቲስት → አርቲስት  
የተከበሩ → የተከበሩ  
አምባሳደር → አምባሳደር  
ኮማንደር → ኮማንደር  
ብርጋድየር ጀኔራል → ብርጋድየር ጀኔራል  
ሌተናል ኮሌኔል → ሌተናል ኮሎኔል  
ሹምፕ/ር → ሹምፕሮፌሰር  
አፄ → አፄ  
መቶ አለቃ → መቶ አለቃ  
ሚስተር → ሚስተር  
ድያቆን → ድያቆን  
ባላምበራስ → ባላምበራስ  
ብላቴን ጌታ → ብላቴን ጌታ  
ፊታውራሪ → ፊታውራሪ  
አባ → አባ  
ደጃዝማች → ደጃዝማች  
ሜጀር → ሜጀር  
በጅሮንድ → በጅሮንድ  
ግራዝማች → ግራዝማች
